TILEMAP
33 24 							-- Size of tile map in tiles
16 16 							-- Tile size & block size
images/tilesheet.png 			-- Tilesheet
16 16 							-- Number of tiles in tilesheet
33 33 33 33 33 33 33 33 33 33 33 33 33 33 33 33 33 33 33 33 33 33 33 33 00 00 65 66 67 68 69 62 00
33 00 00 00 00 00 00 00 00 00 00 00 00 00 00 00 00 00 00 00 00 00 00 33 00 49 49 49 49 49 49 49 00
33 00 00 00 00 00 00 00 00 00 00 00 00 00 00 00 00 00 00 00 00 00 00 33 00 00 00 00 00 00 00 00 00
33 00 00 00 00 00 00 00 00 00 00 00 00 00 00 00 00 00 00 00 00 00 00 33 00 00 00 00 00 00 00 00 00
33 00 00 00 11 12 13 14 13 14 00 00 00 00 13 14 13 14 11 12 00 00 00 33 00 00 00 00 00 00 00 00 00
33 00 11 12 00 00 00 00 00 00 13 14 13 14 00 00 00 00 00 00 11 12 00 33 00 70 66 71 67 72 73 62 00
33 00 11 12 11 12 11 12 11 12 00 00 00 00 11 12 11 12 11 12 11 12 00 33 00 49 49 49 49 49 49 49 00
33 00 15 16 15 16 15 16 15 16 00 00 00 00 15 16 15 16 15 16 15 16 00 33 00 00 00 00 00 00 00 00 00
33 00 15 16 00 00 00 00 00 00 00 00 00 00 00 00 00 00 00 00 15 16 00 33 00 00 00 00 00 00 00 00 00
33 00 15 16 15 16 15 16 00 00 00 00 00 00 15 16 15 16 15 16 15 16 00 33 00 00 00 00 00 00 00 00 00
33 00 17 18 17 18 17 18 00 00 00 00 00 00 17 18 17 18 17 18 17 18 00 33 00 00 00 00 00 00 00 00 00
33 00 17 18 00 00 00 00 00 00 00 00 00 00 00 00 00 00 00 00 17 18 00 33 00 00 74 71 75 68 73 62 00
33 00 00 00 17 18 13 14 00 00 00 00 00 00 00 00 00 00 13 14 17 18 00 33 00 00 00 00 00 00 49 52 00
33 00 00 00 00 00 00 00 00 00 00 00 00 00 00 00 00 00 00 00 00 00 00 33 00 00 00 00 00 00 00 00 00
33 00 00 00 00 00 00 00 00 00 00 00 00 00 00 00 00 00 00 00 00 00 00 33 00 00 00 00 00 00 00 00 00
33 00 00 00 00 00 00 00 00 00 00 00 00 00 00 00 00 00 00 00 00 00 00 33 00 00 00 76 77 67 78 62 00
33 00 00 00 00 00 00 00 00 00 00 00 00 00 00 00 00 00 00 00 00 00 00 33 00 00 00 00 00 00 49 50 00
33 00 00 00 00 00 00 00 00 00 00 00 00 00 00 00 00 00 00 00 00 00 00 33 00 00 00 00 00 00 00 00 00
33 00 11 12 11 12 00 00 00 00 00 00 00 00 00 00 00 00 11 12 11 12 00 33 00 00 00 00 00 00 00 00 00
33 00 15 16 00 00 00 00 00 00 00 00 00 00 00 00 00 00 00 00 15 16 00 33 00 76 77 72 65 66 79 68 00
33 00 17 18 17 18 00 00 00 00 00 00 00 00 00 00 00 00 17 18 17 18 00 33 00 00 74 77 80 64 68 00 00
33 00 00 00 00 00 00 00 00 00 00 00 00 00 00 00 00 00 00 00 00 00 00 33 00 00 00 00 00 00 00 00 00
33 00 00 00 00 00 00 00 00 00 00 00 00 00 00 00 00 00 00 00 00 00 00 33 00 00 00 80 66 66 65 62 00
33 33 33 33 33 33 33 33 00 00 00 00 00 00 00 00 33 33 33 33 33 33 33 33 00 00 00 00 00 00 49 53 00