TILEMAP
24 78 							-- Size of tile map in tiles
16 16 							-- Tile size & block size
images/tilesheet.png 			-- Tilesheet
16 16 							-- Number of tiles in tilesheet
34  34  34  34  34  34  34  34  34  34  34  34  34  34  34  34  34  34  34  34  34  34  34  34
34  00  00  00  00  00  00  00  13  14  13  14  13  14  13  14  00  00  00  00  00  00  00  34
34  00  31  32  17  18  11  12  00  00  00  00  00  00  00  00  11  12  17  18  31  32  00  34
34  00  121 122 17  18  00  00  00  00  117 118 117 118 00  00  00  00  17  18  121 122 00  34
34  00  123 124 17  18  00  00  00  00  119 120 119 120 00  00  00  00  17  18  123 124 00  34
34  00  34  34  21  22  17  18  17  18  19  20  19  20  17  18  17  18  21  22  34  34  34  34
34  00  121 122 21  22  00  00  00  00  121 122 121 122 00  00  00  00  21  22  121 122 00  34
34  00  123 124 21  22  11  12  00  00  123 124 123 124 00  00  11  12  21  22  123 124 00  34
34  00  47  48  21  22  00  00  00  00  34  34  34  34  00  00  00  00  21  22  47  48  00  34
34  00  121 122 21  22  11  12  00  00  17  18  17  18  00  00  11  12  21  22  121 122 00  34
34  00  123 124 21  22  00  00  00  00  00  00  00  00  00  00  00  00  21  22  123 124 00  34
34  34  34  34  17  18  11  12  00  00  117 118 117 118 11  12  11  12  17  18  34  34  34  34
34  00  00  00  17  18  00  00  00  00  119 120 119 120 00  00  00  00  17  18  129 130 00  34
34  00  00  00  17  18  00  00  00  00  00  00  00  00  00  00  00  00  17  18  131 132 00  34
34  00  00  00  17  18  11  12  00  00  137 138 137 138  00  00  11  12  17  18  00  00  00  34
34  00  00  00  00  00  00  00  00  00  139 140 139 140  00  00  00  00  00  00  00  00  00  34
34  00  00  00  00  00  00  00  00  00  31  32  31  32  00  00  00  00  00  00  00  00  00  34
34  00  00  00  00  00  00  00  00  00  00  00  00  00  00  00  00  00  00  00  00  00  00  34
34  00  00  00  00  00  00  00  00  00  00  00  00  00  00  00  00  00  00  00  00  00  00  34
34  00  00  00  00  00  00  00  00  00  00  00  00  00  00  00  00  00  00  00  00  00  00  34
34  00  00  00  00  00  00  00  00  00  00  00  00  00  00  00  00  00  00  00  00  00  00  34
34  00  00  00  00  00  00  00  00  00  00  00  00  00  00  00  00  00  00  00  00  00  00  34
34  00  00  00  00  00  00  00  00  00  00  00  00  00  00  00  00  00  00  00  00  00  00  34
34  34  34  34  34  34  34  34  00  00  00  00  00  00  00  00  34  34  34  34  34  34  34  34
00  00  00  00  00  00  00  00  00  00  00  00  00  00  00  00  00  00  00  00  00  00  00  00
00  00  00  00  00  00  00  00  00  00  00  00  00  00  00  00  00  00  00  00  00  00  00  00
34  34  34  34  34  34  34  34  34  34  34  34  34  34  34  34  34  34  34  34  34  34  34  34
34  00  00  00  00  00  00  00  00  00  00  00  00  00  00  00  00  00  00  00  00  00  00  34
34  00  00  00  00  00  21  22  11  12  21  22  11  12  21  22  11  12  00  00  00  00  00  34
34  00  00  00  00  00  11  12  21  22  11  12  21  22  11  12  21  22  00  00  00  00  00  34
34  00  00  00  00  00  00  00  00  00  00  00  00  00  00  00  00  00  00  00  00  00  00  34
34  00  00  00  00  00  00  00  00  00  00  00  00  00  00  00  00  00  00  00  00  00  00  34
34  00  00  00  00  00  34  34  21  22  21  22  21  22  21  22  34  34  00  00  00  00  00  34
34  00  00  00  00  00  34  34  11  12  11  12  11  12  11  12  34  34  00  00  00  00  00  34
34  00  00  00  00  00  34  34  00  00  00  00  00  00  00  00  34  34  00  00  00  00  00  34
34  00  11  12  17  18  34  34  00  00  00  00  00  00  00  00  34  34  11  12  17  18  00  34
34  00  00  00  00  00  34  34  15  16  15  16  15  16  15  16  34  34  00  00  00  00  00  34
34  00  00  00  00  00  34  34  113 114 15  16  15  16  17  18  34  34  00  00  00  00  00  34
34  00  00  00  00  00  34  34  115 116 00  00  00  00  17  18  34  34  00  00  00  00  00  34
34  00  00  00  00  00  34  34  11  12  34  34  34  34  11  12  34  34  00  00  00  00  00  34
34  00  00  00  00  00  00  00  00  00  00  00  00  00  00  00  00  00  00  00  00  00  00  34
34  00  00  00  00  00  00  00  00  00  00  00  00  00  00  00  00  00  00  00  00  00  00  34
34  00  00  00  00  00  00  00  00  00  00  00  00  00  00  00  00  00  00  00  00  00  00  34
34  00  00  00  00  00  00  00  00  00  00  00  00  00  00  00  00  00  00  00  00  00  00  34
34  00  00  00  00  00  00  00  00  00  00  00  00  00  00  00  00  00  00  00  00  00  00  34
34  00  00  00  00  00  00  00  00  00  00  00  00  00  00  00  00  00  00  00  00  00  00  34
34  00  00  00  00  00  00  00  00  00  00  00  00  00  00  00  00  00  00  00  00  00  00  34
34  00  11  12  17  18  00  00  00  00  00  00  00  00  00  00  00  00  11  12  17  18  00  34
34  00  00  00  00  00  00  00  00  00  00  00  00  00  00  00  00  00  00  00  00  00  00  34
34  34  34  34  34  34  34  34  00  00  00  00  00  00  00  00  34  34  34  34  34  34  34  34
00  00  00  00  00  00  00  00  00  00  00  00  00  00  00  00  00  00  00  00  00  00  00  00
00  00  00  00  00  00  00  00  00  00  00  00  00  00  00  00  00  00  00  00  00  00  00  00
34  34  34  34  34  34  34  34  34  34  34  34  34  34  34  34  34  34  34  34  34  34  34  34
34  00  00  00  00  00  00  00  00  00  00  00  00  00  00  00  00  00  00  00  00  00  00  34
34  00  00  00  00  00  00  00  00  00  00  00  00  00  00  00  00  00  00  00  00  00  00  34
34  00  11  12  00  00  00  00  00  00  00  00  00  00  00  00  00  00  00  00  11  12  00  34
34  00  15  16  00  00  00  00  00  00  00  00  00  00  00  00  00  00  00  00  15  16  00  34
34  00  11  12  00  00  00  00  00  00  00  00  00  00  00  00  00  00  00  00  11  12  00  34
34  34  34  34  00  00  11  12  11  12  11  12  11  12  11  12  11  12  00  00  34  34  34  34
34  00  113 114 00  00  17  18  17  18  17  18  17  18  17  18  17  18  00  00  00  00  00  34
34  00  115 116 00  00  17  18  15  16  17  18  15  16  17  18  15  16  00  00  00  00  00  34
34  00  00  00  00  00  15  16  15  16  15  16  15  16  15  16  15  16  00  00  00  00  00  34
34  00  00  00  00  00  17  18  15  16  17  18  15  16  17  18  15  16  00  00  00  00  00  34
34  00  00  00  00  00  11  12  11  12  11  12  11  12  11  12  11  12  00  00  00  00  00  34
34  00  11  12  00  00  34  34  34  34  00  00  00  00  34  34  34  34  00  00  11  12  00  34
34  00  15  16  00  00  00  00  00  00  00  00  00  00  00  00  00  00  00  00  15  16  00  34
34  00  11  12  00  00  00  00  00  00  00  00  00  00  00  00  00  00  00  00  11  12  00  34
34  34  34  34  00  00  00  00  00  00  00  00  00  00  00  00  00  00  00  00  34  34  34  34
34  00  00  00  00  00  00  00  00  00  00  00  00  00  00  00  00  00  00  00  00  00  00  34
34  00  00  00  00  00  00  00  00  00  00  00  00  00  00  00  00  00  00  00  00  00  00  34
34  00  00  00  00  00  00  00  00  00  00  00  00  00  00  00  00  00  00  00  00  00  00  34
34  00  00  00  00  00  00  00  00  00  00  00  00  00  00  00  00  00  00  00  00  00  00  34
34  00  00  00  00  00  00  00  00  00  00  00  00  00  00  00  00  00  00  00  00  00  00  34
34  00  00  00  00  00  00  00  00  00  00  00  00  00  00  00  00  00  00  00  00  00  00  34
34  00  00  00  00  00  00  00  00  00  00  00  00  00  00  00  00  00  00  00  00  00  00  34
34  34  34  34  34  34  34  34  00  00  00  00  00  00  00  00  34  34  34  34  34  34  34  34
00  00  00  00  00  00  00  00  00  00  00  00  00  00  00  00  00  00  00  00  00  00  00  00
00  00  00  00  00  00  00  00  00  00  00  00  00  00  00  00  00  00  00  00  00  00  00  00 