TILEMAP
24 78 							-- Size of tile map in tiles
16 16 							-- Tile size & block size
images/tilesheet.png 			-- Tilesheet
16 16 							-- Number of tiles in tilesheet
36  36  36  36  36  36  36  36  36  36  36  36  36  36  36  36  36  36  36  36  36  36  36  36
36  00  121 122 121 122 121 122 121 122 121 122 121 122 121 122 121 122 121 122 121 122 00  36
36  00  123 124 123 124 123 124 123 124 123 124 123 124 123 124 123 124 123 124 123 124 00  36
36  00  129  130  11  12  13  14  13  14  13  14  13  14  13  14  13  14  11  12  11  12  00  36
36  00  131  132  11  12  13  14  47  48  47  48  47  48  47  48  13  14  11  12  11  12  00  36
36  36  36  36  36  36  36  36  137 138 137 138 137 138 137 138 36  36  36  36  36  36  36  36
36  00  00  00  00  00  00  00  139 140 139 140 139 140 139 140 00  00  00  00  00  00  00  36
36  00  11  12  11  12  00  00  00  00  11  12  11  12  00  00  00  00  11  12  11  12  00  36
36  00  125 126 00  00  11  12  137 138 137 138 137 138 137 138 11  12  00  00  125 126 00  36
36  00  127 128 00  00  11  12  139 140 139 140 139 140 139 140 11  12  00  00  127 128 00  36
36  00  11  12  11  12  00  00  00  00  11  12  11  12  00  00  00  00  11  12  11  12  00  36
36  00  125 126 125 126 125 126 137 138 137 138 137 138 137 138 125 126 125 126 125 126 00  36
36  00  127 128 127 128 127 128 139 140 139 140 139 140 139 140 127 128 127 128 127 128 00  36
36  36  36  36  36  36  36  36  11  12  31  32  11  12  31  32  36  36  36  36  36  36  36  36
36  00  00  00  00  00  00  00  31  32  11  12  31  32  11  12  00  00  00  00  00  00  00  36
36  00  00  00  00  00  00  00  00  00  00  00  00  00  00  00  00  00  00  00  00  00  00  36
36  00  00  00  00  00  00  00  00  00  00  00  00  00  00  00  00  00  00  00  00  00  00  36
36  00  00  00  00  00  00  00  00  00  00  00  00  00  00  00  00  00  00  00  00  00  00  36
36  00  00  00  00  00  00  00  00  00  00  00  00  00  00  00  00  00  00  00  00  00  00  36
36  00  00  00  00  00  00  00  00  00  00  00  00  00  00  00  00  00  00  00  00  00  00  36
36  00  00  00  00  00  00  00  00  00  00  00  00  00  00  00  00  00  00  00  00  00  00  36
36  00  00  00  00  00  00  00  00  00  00  00  00  00  00  00  00  00  00  00  00  00  00  36
36  00  00  00  00  00  00  00  00  00  00  00  00  00  00  00  00  00  00  00  00  00  00  36
36  36  36  36  36  36  36  36  00  00  00  00  00  00  00  00  36  36  36  36  36  36  36  36
00  00  00  00  00  00  00  00  00  00  00  00  00  00  00  00  00  00  00  00  00  00  00  00
00  00  00  00  00  00  00  00  00  00  00  00  00  00  00  00  00  00  00  00  00  00  00  00
36  36  36  36  36  36  36  36  36  36  36  36  36  36  36  36  36  36  36  36  36  36  36  36
36  00  00  00  13  14  00  00  00  00  13  14  13  14  00  00  00  00  13  14  00  00  00  36
36  00  00  00  13  14  00  00  00  00  00  00  00  00  00  00  00  00  13  14  00  00  00  36
36  00  13  14  13  14  00  00  00  00  00  00  00  00  00  00  00  00  13  14  13  14  00  36
36  00  00  00  00  00  00  00  00  00  00  00  00  00  00  00  00  00  00  00  00  00  00  36
36  00  00  00  00  00  00  00  00  00  19  20  19  20  00  00  00  00  00  00  00  00  00  36
36  00  11  12  00  00  00  00  19  20  17  18  17  18  19  20  00  00  00  00  00  00  00  36
36  00  11  12  00  00  19  20  17  18  36  36  36  36  17  18  19  20  00  00  00  00  00  36
36  00  11  12  19  20  17  18  11  12  117 118 121 122 11  12  17  18  19  20  00  00  00  36
36  00  19  20  17  18  17  18  11  12  119 120 123 124 11  12  17  18  17  18  19  20  00  36
36  00  00  00  19  20  17  18  11  12  11  12  11  12  11  12  17  18  19  20  11  12  00  36
36  00  00  00  00  00  19  20  17  18  17  18  17  18  17  18  19  20  00  00  11  12  00  36
36  00  00  00  00  00  00  00  19  20  17  18  17  18  19  20  00  00  00  00  11  12  00  36
36  00  00  00  00  00  00  00  00  00  19  20  19  20  00  00  00  00  00  00  00  00  00  36
36  00  00  00  00  00  00  00  00  00  00  00  00  00  00  00  00  00  00  00  00  00  00  36
36  00  00  00  00  00  00  00  00  00  00  00  00  00  00  00  00  00  00  00  00  00  00  36
36  00  00  00  00  00  00  00  00  00  00  00  00  00  00  00  00  00  00  00  00  00  00  36
36  00  00  00  00  00  00  00  00  00  00  00  00  00  00  00  00  00  00  00  00  00  00  36
36  00  00  00  00  00  00  00  00  00  00  00  00  00  00  00  00  00  00  00  00  00  00  36
36  00  00  00  00  00  00  00  00  00  00  00  00  00  00  00  00  00  00  00  00  00  00  36
36  00  00  00  00  00  00  00  00  00  00  00  00  00  00  00  00  00  00  00  00  00  00  36
36  00  00  00  00  00  00  00  00  00  00  00  00  00  00  00  00  00  00  00  00  00  00  36
36  00  00  00  00  00  00  00  00  00  00  00  00  00  00  00  00  00  00  00  00  00  00  36
36  36  36  36  36  36  36  36  00  00  00  00  00  00  00  00  36  36  36  36  36  36  36  36
00  00  00  00  00  00  00  00  00  00  00  00  00  00  00  00  00  00  00  00  00  00  00  00
00  00  00  00  00  00  00  00  00  00  00  00  00  00  00  00  00  00  00  00  00  00  00  00
36  36  36  36  36  36  36  36  36  36  36  36  36  36  36  36  36  36  36  36  36  36  36  36
36  00  00  00  00  00  00  00  00  00  00  00  00  00  00  00  00  00  00  00  00  00  00  36
36  00  00  00  00  00  00  00  00  00  00  00  00  00  00  00  00  00  00  00  00  00  00  36
36  00  00  00  36  36  00  00  00  00  00  00  00  00  00  00  00  00  36  36  00  00  00  36
36  00  00  00  00  00  36  36  00  00  00  00  00  00  00  00  36  36  00  00  00  00  00  36
36  00  00  00  00  00  113 114 00  00  00  00  00  00  00  00  00  00  00  00  00  00  00  36
36  00  00  00  00  00  115 116 15  16  15  16  15  16  15  16  00  00  00  00  00  00  00  36
36  00  00  00  00  00  00  00  15  16  15  16  15  16  15  16  00  00  00  00  00  00  00  36
36  00  00  00  00  00  00  00  00  00  00  00  00  00  00  00  00  00  00  00  00  00  00  36
36  00  00  00  00  00  36  36  00  00  00  00  00  00  00  00  36  36  00  00  00  00  00  36
36  00  00  00  36  36  13  14  00  00  00  00  00  00  00  00  13  14  36  36  00  00  00  36
36  00  36  36  13  14  11  12  00  00  00  00  00  00  00  00  11  12  13  14  36  36  00  36
36  36  13  14  11  12  00  00  00  00  00  00  00  00  00  00  00  00  11  12  13  14  36  36
36  00  11  12  00  00  00  00  00  00  00  00  00  00  00  00  00  00  00  00  11  12  00  36
36  00  00  00  00  00  00  00  00  00  00  00  00  00  00  00  00  00  00  00  00  00  00  36
36  00  00  00  00  00  00  00  00  00  00  00  00  00  00  00  00  00  00  00  00  00  00  36
36  00  00  00  00  00  00  00  00  00  00  00  00  00  00  00  00  00  00  00  00  00  00  36
36  00  00  00  00  00  00  00  00  00  00  00  00  00  00  00  00  00  00  00  00  00  00  36
36  00  00  00  00  00  00  00  00  00  00  00  00  00  00  00  00  00  00  00  00  00  00  36
36  00  00  00  00  00  00  00  00  00  00  00  00  00  00  00  00  00  00  00  00  00  00  36
36  00  00  00  00  00  00  00  00  00  00  00  00  00  00  00  00  00  00  00  00  00  00  36
36  00  00  00  00  00  00  00  00  00  00  00  00  00  00  00  00  00  00  00  00  00  00  36
36  00  00  00  00  00  00  00  00  00  00  00  00  00  00  00  00  00  00  00  00  00  00  36
36  36  36  36  36  36  36  36  00  00  00  00  00  00  00  00  36  36  36  36  36  36  36  36
00  00  00  00  00  00  00  00  00  00  00  00  00  00  00  00  00  00  00  00  00  00  00  00
00  00  00  00  00  00  00  00  00  00  00  00  00  00  00  00  00  00  00  00  00  00  00  00


#Example of the roof' hole for this 
36  36  36  36  36  36  36  36  37  38  37  38  37  38  37  38  36  36  36  36  36  36  36  36
